1 2 3 2 1 6 1 2 1 2 3 2 1 2 1 2 1 2 1 2 1 2 1 2
9 0 0 0 2 0 0 1 0 0 0 0 0 0 0 1 2 0 1 1 0 0 0 1
1 2 1 0 1 0 1 2 0 2 1 0 2 1 0 2 1 0 0 0 0 1 0 2
2 0 0 0 2 0 0 1 0 1 0 0 1 0 0 0 0 0 1 2 1 2 0 8
3 0 0 1 0 1 0 2 0 2 0 1 2 1 0 0 1 0 1 0 1 1 0 2
2 0 0 0 0 2 0 1 0 1 0 0 0 0 1 2 1 2 1 0 0 0 0 3
1 2 1 2 0 1 0 2 0 2 1 2 1 2 1 0 1 0 1 0 1 0 1 2
2 0 0 0 0 0 0 0 0 0 0 0 0 0 0 0 0 0 3 0 1 2 1 1
3 0 1 2 1 2 1 2 1 2 1 2 1 0 1 2 1 2 1 0 0 0 0 2
2 0 2 0 0 1 0 0 0 0 2 0 0 0 0 0 0 0 0 1 0 1 0 3
1 0 1 0 1 1 0 2 1 2 1 0 1 1 0 2 3 2 0 1 1 0 0 2
2 0 0 0 0 0 0 0 0 0 0 0 2 0 0 1 0 2 0 2 0 0 1 1
1 1 2 1 1 0 0 1 0 0 0 1 1 0 2 0 0 1 3 1 0 1 1 2
2 0 0 0 2 0 1 2 0 1 2 1 0 0 1 0 0 0 0 0 0 0 0 1
1 0 1 0 1 0 0 3 0 0 0 0 0 1 0 0 1 1 0 1 2 1 0 2
2 0 2 3 2 0 1 2 1 2 1 2 1 0 0 1 0 1 0 1 0 0 0 3
5 0 0 0 0 0 1 0 0 1 4 0 0 1 0 2 0 0 2 0 0 1 0 2
2 0 1 2 3 2 1 0 1 0 1 2 0 2 0 1 0 1 0 0 2 0 0 1
1 0 0 0 0 0 0 0 2 0 0 0 0 1 0 0 0 0 2 0 1 2 1 2
2 0 1 0 0 1 2 0 1 2 1 0 2 0 0 1 1 0 1 0 0 0 0 1
1 0 2 0 1 2 0 0 0 0 0 0 1 0 1 1 0 0 0 0 4 1 0 2
2 1 1 0 2 0 0 1 0 2 2 0 0 0 3 0 1 2 1 2 1 0 0 1
3 0 0 0 1 1 0 2 0 0 0 0 2 3 7 0 0 0 0 0 0 0 1 2
2 5 3 2 2 1 2 1 2 3 2 1 2 1 2 1 2 1 2 3 2 1 2 1