1 2 3 4 5 6 7 8 1 1 1 1 1
1 0 0 0 0 0 0 0 0 1 0 0 1
2 0 1 1 1 0 0 0 1 0 1 0 1
3 0 0 0 0 0 0 0 1 0 1 0 1
4 0 0 0 0 0 0 0 0 0 0 0 1
5 0 0 0 0 0 0 0 0 0 0 0 1
6 0 0 0 0 1 0 0 0 0 0 0 1
7 0 1 1 1 1 0 0 0 0 0 0 1
8 0 0 0 0 1 0 0 0 0 0 0 1
1 1 1 1 1 1 1 1 1 1 1 1 1
