4 4 4 4 3 3 4 4 4 4 4 4 4 4 4 4 4 4 4 9 9 9
4 0 0 0 0 0 0 0 0 0 0 0 0 0 0 0 0 0 0 0 0 9
4 0 0 0 0 0 0 0 0 7 7 7 6 6 6 6 6 0 6 6 6 4
3 0 0 0 4 0 0 0 0 0 0 7 6 0 0 0 0 0 0 0 7 4
4 4 4 4 4 0 5 0 0 5 0 7 6 0 0 5 0 0 0 5 6 4
8 8 8 8 4 0 0 0 0 0 0 7 6 0 0 0 0 0 0 0 7 4
8 0 0 8 4 0 0 0 0 0 0 7 6 0 0 0 5 0 5 0 6 4
8 0 3 8 4 0 5 0 0 5 0 7 6 0 0 0 0 0 0 0 7 4
8 0 3 8 4 0 0 0 0 0 0 7 6 0 0 5 0 8 0 5 6 4
8 0 0 8 4 0 0 0 0 0 0 7 6 0 0 0 0 0 0 0 7 4
8 0 0 8 4 4 4 0 0 5 0 7 6 0 0 0 5 0 5 0 6 4
8 3 0 8 8 8 4 0 0 0 0 7 6 0 0 0 0 0 0 0 7 4
8 0 0 0 3 0 0 0 0 0 0 7 6 0 0 5 0 8 0 5 6 4
8 0 0 0 0 0 0 0 0 5 0 7 6 0 0 0 0 0 0 0 7 4
8 8 8 8 8 8 4 0 0 0 0 7 6 6 6 0 5 0 5 0 6 4
4 4 4 4 4 4 4 0 0 7 7 7 7 7 6 0 0 0 0 0 0 4
4 1 1 1 1 1 4 0 0 7 1 1 1 1 0 0 0 0 0 0 0 4
4 1 0 0 0 0 0 0 0 0 0 0 1 1 5 0 6 0 6 0 5 4
4 1 0 0 0 0 0 0 0 0 0 0 1 3 0 0 0 6 0 0 0 3
4 1 0 0 0 0 0 0 0 0 0 0 1 1 5 0 0 0 0 0 5 4
4 1 1 1 1 1 1 1 1 1 1 1 1 1 4 4 2 4 2 4 4 4
